111111111111111111111111111111111
100000000000000000000000000000001
100000000000000000000000000000001
100000000C0000000000000C000000001
1E1C00000000000000000000000000001
110000000000100000000000000000001
10000000000010000000000C000000001
100000C00001001000000000000000001
100000000000010000000000000000001
100000000000000000000000000000001
1000C0000000000000P00000000000001
100000000000000000000000000000001
1000000CC0000000000000C0000000001
100000000000000000000000000000001
100000000000000000000000000000001
100000000000000000000000000000001
100000000000000000000000000000001
100000000000000000000000000000001
111111111111111111111111111111111
