111111111111111111111111111111111
100000000000000000000000000000001
100000000000000000000000000000001
100000000000000000000000000000001
1E0C00000000000000000000000000001
100000000000100000000000000000001
100000000000100000000000000000001
100000000001001000000000000000001
100000000000010000000000000000001
100000000000000000000000000000001
100000000000000000P00000000000001
100000000000000000000000000000001
100000000000000000000000000000001
100000000000000000000000000000001
100000000000000000000000000000001
100000000000000000000000000000001
100000000000000000000000000000001
100000000000000000000000000000001
111111111111111111111111111111111
