1111111
10010P1
110C011
10010E1
1111111