1111111
10010P1
1100011
10010E1
1111111
