1111111
1100PE1
1C01111
1111111
